+-----------------------------------------------------------------------------+
|                                FRONTEND LAYER                               |
|                     Next.js 16 (Turbopack) SPA Dashboard                    |
|  +-----------------------+  +------------------------+  +----------------+  |
|  |   Drag & Drop Zone    |  |  Procurement Planner   |  | Reasoning Log  |  |
|  +-----------------------+  +------------------------+  +----------------+  |
+--------------------------------------|--------------------------------------+
                                       | 
                                       | REST APIs / JSON Payloads
                                       v
+-----------------------------------------------------------------------------+
|                                BACKEND LAYER                                |
|                        FastAPI ASGI Server (Uvicorn)                        |
|                                                                             |
|   +---------------------------------------------------------------------+   |
|   |                  BOUNDARY SECURITY & INGESTION NODE                 |   |
|   |         Strict Extension Whitelist & Path-Traversal Mitigation      |   |
|   +----------------------------------|----------------------------------+   |
|                                      |                                      |
|             +------------------------+------------------------+             |
|             |                                                 |             |
|             v [Primary: Structured PDFs]                      v [Raster]    |
|   +--------------------------+                      +-------------------+   |
|   | NATIVE TEXT PIPELINE     |                      | VISION FALLBACK   |   |
|   | IBM Docling Engine       |                      | Local OCR Engine  |   |
|   | (Table/Layout Parsing)   |                      | (Scanned/Images)  |   |
|   +-----------+--------------+                      +---------+---------+   |
|               |                                               |             |
|               +----------------------+------------------------+             |
|                                      |                                      |
|                                      v                                      |
|   +---------------------------------------------------------------------+   |
|   |                     DETERMINISTIC ONTOLOGY ENGINE                   |   |
|   |        Regex Pattern Matcher against construction_ontology.json     |   |
|   +----------------------------------|----------------------------------+   |
|                                      v                                      |
|   +---------------------------------------------------------------------+   |
|   |                    REASONING & SYNTHESIS LAYER                      |   |
|   |      Blended Confidence Matrix (Ontology Math + Validation)         |   |
|   |        Optional LLM Enrichment for Complex Blueprint Context        |   |
|   +----------------------------------|----------------------------------+   |
|                                      v                                      |
|   +---------------------------------------------------------------------+   |
|   |                         PERSISTENCE ENGINE                          |   |
|   |                   SQLite DB via SQLAlchemy ORM                      |   |
|   +---------------------------------------------------------------------+   |
+-----------------------------------------------------------------------------+